Name,Volume,Ask Size,Ask Price,Bid Size,Bid Price,Last Price,Shares Matched,Shares Routed
UVXY,3231212,300,17.59,1944,17.58,17.58,3172441,58771
VIXY,672250,408,20.09,1459,20.07,20.08,660798,11452
ITB,522846,300,57.67,200,57.65,57.63,522470,376
IEFA,309517,5300,64.49,600,64.48,64.46,297201,12316
SVXY,254662,706,48.54,124,48.53,48.54,252399,2263
VXX,232892,500,26.89,200,26.77,26.83,228816,4076
ARKG,229895,200,37.22,100,37.19,37.18,229361,534
IAGG,187273,1100,51.31,268,51.30,51.30,186767,506
INDA,96143,2400,43.85,4134,43.83,43.84,88180,7963
USHY,86962,6100,37.51,2428,37.50,37.50,85184,1778
MTUM,84973,50,148.60,300,148.58,148.52,84873,100
UVIX,82533,300,23.45,200,23.40,23.39,75875,6658
USMV,81506,400,74.81,500,74.80,74.79,81206,300
EFV,75768,300,47.34,1506,47.33,47.32,74462,1306
IGV,64202,100,301.54,100,301.39,301.00,64202,0
QUAL,62192,450,124.66,150,124.64,124.64,62192,0
EZU,59067,400,39.76,1509,39.75,39.74,58572,495
BBEU,47522,8700,51.08,800,51.06,51.06,47522,0
VLUE,46772,300,99.63,300,99.61,99.63,45664,1108
EFG,45103,150,87.82,150,87.78,87.81,44903,200
MOAT,39851,600,69.59,100,69.57,69.57,39851,0
FGRO,39807,1100,15.15,2200,15.13,15.10,39807,0
RYLD,39770,1,22.32,1000,22.31,22.31,39108,662
GOVT,36842,53901,24.37,15558,24.36,24.36,36842,0
HYD,36011,500,55.08,200,55.07,55.08,35911,100
IDV,33415,3500,30.00,3008,29.98,29.99,33415,0
IGE,32922,2000,38.56,100,38.55,38.57,32922,0
PAVE,31750,1390,26.45,600,26.43,26.44,29250,2500
REM,31204,300,29.54,400,29.53,29.53,30704,500
PICK,29464,4,45.05,1100,44.92,45.01,29464,0
TRTY,28850,900,27.10,38,27.00,27.13,28850,0
CBOE,27982,2,114.59,110,114.43,114.46,27882,100
VNM,27171,100,16.98,200,16.96,16.97,26719,452
FLOT,27078,87725,50.46,4348,50.45,50.46,27078,0
ITA,26198,200,104.90,2,104.80,104.85,26187,11
COWZ,25452,200,47.75,100,47.73,47.75,25452,0
ARKQ,24580,150,57.25,50,57.23,57.21,24580,0
BBJP,23793,1324,46.46,1100,46.41,46.44,20388,3405
SVIX,23180,300,10.94,3000,10.92,10.92,19979,3201
AAAU,21106,13860,18.76,21800,18.75,18.76,20310,796
JPST,20560,44523,50.24,39127,50.23,50.23,20560,0
EFAV,19671,300,68.38,200,68.37,68.35,19248,423
IFRA,19613,800,37.22,106,37.14,37.29,19613,0
EEMV,18585,100,58.54,50,58.52,58.53,10985,7600
NEAR,17866,3411,49.52,7191,49.51,49.52,17866,0
ICF,15704,1000,71.34,100,71.28,71.32,15704,0
BBAX,15479,2522,51.79,1049,51.77,51.77,13179,2300
NOBL,13893,200,93.78,100,93.74,93.86,13893,0
ACWV,13406,100,101.42,1000,101.39,101.43,11396,2010
ECH,13064,300,25.55,100,25.52,25.54,13064,0
OGIG,12193,400,31.05,100,30.96,31.00,12193,0
BUFT,11700,200,19.41,300,19.35,19.44,11700,0
ESGV,11456,1000,73.89,1200,73.81,73.75,11456,0
HFGO,10900,600,13.77,600,13.73,13.81,10900,0
OMFL,9562,200,45.68,400,45.64,45.72,9562,0
ARKX,9539,2500,15.45,300,15.43,15.43,9421,118
CNYA,9470,100,32.70,1500,32.64,32.76,5990,3480
IYZ,8936,600,27.21,100,27.20,27.21,8936,0
BBUS,8575,200,75.20,200,75.14,75.82,8575,0
SLVP,8411,2,12.40,400,12.35,12.49,8411,0
ICSH,7452,1851,50.12,8740,50.11,50.12,7452,0
FCPI,7330,2500,32.47,2500,32.39,32.41,7330,0
VSGX,7014,1300,52.85,100,52.81,52.81,7014,0
GOVZ,6700,5027,17.15,5164,17.11,17.09,6700,0
NULG,6531,300,54.17,200,54.08,54.12,6531,0
ICVT,6488,105,77.63,700,77.52,77.49,6488,0
FCTR,6196,500,29.39,500,29.35,29.57,6196,0
SYLD,6112,300,60.82,300,60.73,60.80,6112,0
NUSC,6106,500,36.91,400,36.83,36.99,6106,0
BBIN,6048,631,51.50,300,51.44,51.76,6048,0
BUFR,6019,400,22.55,500,22.48,22.67,6019,0
BBCA,6015,1400,64.35,1000,64.29,64.29,6015,0
PTLC,5988,1500,37.08,1200,37.05,37.13,5988,0
SMIN,5895,1246,56.35,100,56.17,56.45,5895,0
TDV,5789,500,57.78,500,57.66,57.74,5789,0
MSTB,5675,2400,28.18,2400,28.07,28.19,5575,100
TAIL,5573,500,17.03,500,17.00,17.00,5473,100
IEO,5551,200,80.51,300,80.42,80.42,5351,200
CALF,5218,700,37.90,800,37.84,37.85,5218,0
ITM,5213,600,45.73,802,45.70,45.69,5213,0
VXZ,5177,1000,29.21,1000,29.14,29.21,4737,440
FDG,5084,1000,62.27,1000,62.17,62.16,5084,0
SMDV,5021,200,61.62,500,61.54,61.56,5021,0
HEFA,4901,1800,33.13,1107,33.12,33.12,4901,0
GCOW,4880,300,32.81,300,32.76,32.95,4880,0
SMMD,4806,300,57.49,700,57.42,57.39,4806,0
GDMN,4645,100,29.44,100,29.24,29.37,4645,0
UJAN,4494,400,29.93,80,29.90,29.96,4494,0
JMST,4488,1000,50.49,1600,50.48,50.47,4488,0
FMAR,4050,400,32.16,500,32.06,32.26,4050,0
IYT,3949,400,242.14,200,241.87,241.87,3949,0
PAPR,3904,500,28.40,100,28.33,28.36,3904,0
IBMN,3784,600,26.31,600,26.29,26.30,3784,0
MEAR,3725,100,49.65,432,49.61,49.62,3725,0
DINT,3723,600,16.05,300,15.97,16.14,3723,0
IYJ,3673,100,98.39,100,98.34,98.42,3673,0
EPRF,3551,381,20.28,800,20.23,20.25,3551,0
CTRU,3478,1400,14.20,5900,14.18,14.20,3478,0
VIXM,3452,800,34.68,800,34.62,34.60,3452,0
JEMA,3328,1000,37.59,1000,37.50,37.75,3328,0
HEEM,3308,1000,26.01,1000,25.94,26.15,3308,0
BBRE,3305,100,105.51,100,105.40,106.01,3305,0
VUSB,3243,3812,49.36,302,49.35,49.35,3243,0
DMAR,3126,400,31.22,200,31.06,31.22,3126,0
EMGF,3100,800,45.59,800,45.46,45.83,3100,0
DFEB,3071,3400,34.78,3000,34.64,34.76,3071,0
ESML,2996,100,35.14,600,35.07,35.35,2996,0
NULV,2988,500,36.59,400,36.56,36.85,2988,0
FBCG,2981,100,25.87,1700,25.79,25.78,2981,0
IGRO,2786,500,61.60,300,61.31,61.45,2786,0
PRNT,2566,900,24.63,600,24.52,24.53,2566,0
SMMV,2508,400,35.96,400,35.88,36.02,2508,0
TMFG,2488,100,26.47,600,26.19,26.37,2488,0
XBTF,2284,5300,37.84,5300,37.78,38.00,2284,0
IQDG,2278,1000,33.19,1000,33.16,33.32,2278,0
USEP,2198,500,27.35,500,27.24,27.27,2198,0
FAPR,2111,400,30.21,500,30.14,30.39,2111,0
DAPR,2101,1000,30.58,300,30.43,30.63,2101,0
JCPB,2060,800,49.51,900,49.44,49.46,2060,0
HEGD,1895,1000,17.87,800,17.72,17.87,1895,0
IGHG,1875,500,70.91,600,70.63,70.80,1875,0
DUDE,1874,2100,25.68,2100,25.61,26.08,1874,0
VCEB,1874,800,64.88,600,64.83,64.97,1874,0
FJAN,1801,500,33.16,200,33.07,33.15,1801,0
HYMU,1800,1300,22.76,392,22.75,22.75,1600,200
TMFS,1786,300,28.30,300,28.08,28.40,1786,0
DFNL,1685,46,28.50,600,28.47,28.62,1685,0
TMFC,1683,1000,36.08,300,35.96,36.00,1683,0
OILK,1674,1200,54.01,910,53.90,53.99,1630,44
DDLS,1667,600,32.44,600,32.38,32.56,1667,0
TMFM,1657,300,24.28,300,24.21,24.20,1257,400
OMFS,1643,500,36.69,500,36.66,36.80,1643,0
LQDI,1631,600,27.75,600,27.69,27.80,1631,0
QJUN,1620,3400,19.26,3200,19.14,19.29,1620,0
FLDR,1464,300,50.01,100,49.98,49.98,1464,0
FDRV,1444,1479,19.81,100,19.74,19.84,1444,0
XMPT,1441,319,23.53,172,23.49,23.55,1441,0
DDEC,1440,400,31.09,100,31.03,31.06,1440,0
BSEP,1422,400,30.88,800,30.72,30.78,1422,0
IZRL,1402,800,21.79,4,21.75,21.78,1402,0
SMB,1381,533,16.86,1000,16.85,16.86,1381,0
DNOV,1369,400,33.39,600,33.33,33.50,1369,0
OUSM,1369,400,33.64,800,33.58,33.82,1369,0
SHYD,1368,431,22.86,10,22.75,22.84,1368,0
KNG,1367,3000,54.19,3000,54.08,54.35,1367,0
LVHI,1349,500,27.06,19,26.97,27.12,1349,0
GTIP,1340,700,55.07,500,55.06,55.09,1340,0
PBEE,1246,300,23.85,300,23.67,23.88,1246,0
EMHY,1239,900,38.19,600,38.17,38.18,1239,0
PSEP,1227,1000,28.91,100,28.85,28.89,1227,0
MLN,1219,2036,18.32,800,18.29,18.31,1219,0
DISV,1211,1300,23.05,23,22.98,23.01,1211,0
IETC,1193,900,47.95,600,47.88,47.95,1193,0
SVAL,1192,1000,28.68,1000,28.62,28.81,1192,0
REGL,1178,600,69.92,500,69.83,69.99,1178,0
NUMV,1167,300,34.53,300,34.48,34.76,1167,0
VFVA,1166,1000,101.10,13,101.00,101.18,1166,0
USMF,1149,1500,39.43,500,39.38,39.44,1149,0
PAWZ,1124,6,60.58,300,60.53,60.55,1124,0
DIVB,1115,100,39.47,700,39.43,39.43,1115,0
PSMO,1101,500,20.38,500,20.26,20.32,1101,0
PSCJ,1100,500,20.30,500,20.18,20.18,1100,0
FCLD,1038,700,18.38,1000,18.33,18.40,1038,0
FDEV,1028,800,25.74,100,25.73,25.59,1028,0
CEFS,1017,300,18.83,300,18.73,18.83,1017,0
IBHC,1000,100,23.71,50,23.69,23.69,1000,0
PMAR,1000,400,31.05,300,30.97,31.07,1000,0
AVDR,949,800,27.07,1,27.00,27.25,949,0
PJAN,927,3400,31.21,3000,31.10,31.33,927,0
DUSA,919,400,29.87,300,29.78,30.22,919,0
BBSA,889,800,48.52,600,48.48,48.48,889,0
PTMC,869,300,34.55,6,34.53,34.55,869,0
HYHG,868,100,61.12,100,60.92,60.95,568,300
NAPR,842,400,36.42,200,36.24,36.60,842,0
FBCV,824,100,28.57,50,28.50,28.57,824,0
DJAN,813,500,31.60,600,31.53,31.58,813,0
DURA,807,200,31.84,200,31.81,31.98,807,0
IEIH,802,400,32.94,400,32.88,32.96,702,100
EAOR,800,400,27.98,400,27.95,27.94,800,0
SECT,769,2500,39.32,200,39.26,39.50,769,0
UJUL,758,1300,26.65,300,26.57,26.79,758,0
IEHS,752,500,41.39,500,41.33,41.42,752,0
HYDB,739,900,47.35,684,47.32,47.46,739,0
DFHY,732,87,22.68,2600,22.64,22.63,732,0
EWUS,706,2000,36.19,200,36.09,36.30,706,0
FLQL,665,100,42.01,1800,41.95,41.96,665,0
IBHG,663,1100,23.04,337,22.99,22.99,663,0
UAPR,643,400,25.61,400,25.50,25.64,643,0
NUMG,631,400,38.56,400,38.45,38.84,631,0
MOTI,616,300,30.07,200,29.98,30.10,616,0
IVAL,608,300,24.74,1,24.69,24.72,608,0
ZECP,607,800,24.11,800,24.03,24.11,604,3
GVAL,606,300,20.37,400,20.28,20.36,606,0
DRSK,603,6000,27.30,6500,27.23,27.27,603,0
UFEB,601,3200,27.18,500,27.10,27.23,601,0
HSUN,600,1100,35.77,600,35.69,35.77,600,0
IBMP,600,800,24.93,600,24.89,24.88,600,0
VFQY,600,900,108.29,700,108.16,108.80,600,0
NUEM,593,210,27.75,300,27.67,27.75,593,0
UAUG,582,3000,28.06,200,27.96,28.12,582,0
UNOV,578,400,28.26,800,28.17,28.33,578,0
UJUN,575,400,28.38,200,28.28,28.42,575,0
DWLD,572,1144,24.77,300,24.69,25.06,572,0
UMAR,557,700,29.33,400,29.25,29.40,557,0
PSFD,553,3000,22.72,500,22.62,22.79,553,0
GMOM,546,800,31.54,300,31.46,31.59,546,0
XVV,545,500,31.52,900,31.43,31.84,545,0
GHYG,515,2100,44.19,100,44.07,44.19,515,0
QMAR,515,400,20.84,300,20.73,20.94,515,0
PTEU,509,587,22.39,4630,22.36,22.40,509,0
FJUL,501,3000,34.31,3200,34.19,34.39,501,0
FFEB,500,28,36.39,3000,36.28,36.58,500,0
FRDM,500,1600,30.34,20,30.20,30.35,500,0
UMAY,500,3000,27.41,700,27.30,27.49,500,0
BUFG,456,100,18.75,100,18.72,18.79,456,0
FLBL,429,1200,24.71,600,24.69,24.70,429,0
BUFF,421,500,34.41,300,34.34,34.56,421,0
VOTE,416,1000,48.58,1000,48.54,48.60,416,0
FYLD,408,347,25.77,200,25.63,26.05,399,9
KAPR,401,400,25.44,200,25.32,25.36,401,0
UOCT,401,400,27.56,3500,27.46,27.60,401,0
IBHB,400,100,24.05,100,24.01,24.02,400,0
XBAP,400,200,26.34,3000,26.22,26.46,400,0
UDEC,397,400,28.88,3500,28.77,28.93,397,0
PSFF,395,3000,21.66,3000,21.53,21.68,395,0
WEED,386,400,13.92,800,13.83,14.00,381,5
GVI,380,1500,107.00,1500,106.82,106.88,380,0
PTNQ,380,724,52.19,700,52.17,52.15,380,0
NURE,377,500,39.51,500,39.42,39.58,377,0
IBMO,367,1500,25.08,2000,25.05,25.11,367,0
WFHY,363,300,47.47,600,47.44,47.48,363,0
MINN,350,2100,22.15,100,22.04,22.07,350,0
CEMB,336,2000,45.39,600,45.26,45.24,336,0
JCPI,336,200,49.98,200,49.88,49.99,336,0
EYLD,335,1600,29.65,1700,29.27,29.78,335,0
IGEB,335,800,46.42,1,46.40,46.46,335,0
FLHY,309,1100,23.84,600,23.81,23.89,309,0
IBMM,308,600,25.75,900,25.73,25.76,308,0
HYIN,306,621,21.70,621,21.65,21.60,306,0
IBHD,302,100,23.34,200,23.31,23.35,302,0
IYLD,302,2700,21.13,300,21.12,21.11,302,0
IDHD,301,200,25.87,88,25.62,25.89,301,0
NUDM,301,500,26.97,200,26.84,27.00,301,0
NJAN,300,600,37.87,300,37.70,37.97,300,0
DIHP,298,300,23.12,1000,23.08,23.20,298,0
IBML,298,700,25.37,500,25.36,25.37,298,0
JPHY,284,138,47.00,900,46.97,47.04,284,0
ATMP,272,1100,18.27,300,18.23,18.31,272,0
DALT,269,400,9.66,400,9.64,9.68,269,0
GAA,262,300,29.09,1,29.05,29.04,262,0
EMTL,251,900,43.82,600,43.76,43.84,251,0
BALT,243,600,25.59,200,25.54,25.51,243,0
OUSA,239,400,42.72,5,42.70,42.88,239,0
FPFD,233,3300,21.59,1,21.50,21.51,233,0
FLQM,231,500,42.92,500,42.76,42.99,231,0
FMAY,230,3400,35.98,3500,35.84,35.88,230,0
FLV,218,1000,59.85,1000,59.75,60.05,218,0
BFEB,216,400,30.57,3000,30.46,30.65,216,0
IDME,216,500,21.24,1000,21.16,21.85,216,0
PSMD,214,3000,21.59,500,21.48,21.57,214,0
RESD,206,1000,27.06,1000,27.03,27.13,206,0
PSFJ,201,500,20.57,500,20.45,20.48,201,0
FPAG,200,300,21.84,700,21.80,21.92,200,0
PJUN,200,900,31.20,700,31.08,31.25,200,0
XTJL,200,200,25.56,200,25.44,25.69,200,0
IECS,198,400,34.68,400,34.65,34.87,198,0
CSM,197,500,49.97,500,49.90,50.17,197,0
ESG,187,500,100.00,500,99.87,100.00,187,0
BLDG,176,200,30.56,125,30.30,30.66,0,176
IAUF,176,100,57.60,100,57.35,57.46,176,0
VFMV,176,1000,100.36,1000,100.24,99.80,176,0
FOCT,175,400,33.27,200,33.15,33.46,175,0
TMDV,169,500,47.81,501,47.71,47.85,169,0
FNOV,162,500,35.96,3400,35.81,36.13,162,0
PWS,156,500,30.51,400,30.46,30.60,156,0
ACIO,152,3000,30.20,500,30.11,30.29,152,0
FRNW,148,1100,21.38,1100,21.28,21.16,148,0
GSEW,144,700,62.37,800,62.29,62.60,144,0
LKOR,143,1700,47.78,15,47.69,47.88,143,0
HCRB,138,2400,36.85,605,36.73,36.83,138,0
TOKE,138,200,10.09,200,9.76,9.90,138,0
ALFA,137,600,61.29,300,61.14,61.61,137,0
ADME,135,6000,38.48,6000,38.38,38.66,135,0
IEFN,135,400,30.35,404,30.30,30.35,135,0
FDEC,132,400,32.26,500,32.23,32.39,132,0
SHAG,119,5,48.07,900,48.03,48.02,119,0
LEAD,118,500,52.02,500,51.94,52.35,118,0
EDEN,114,1600,95.16,1200,94.79,94.80,114,0
IBHF,110,100,23.85,100,23.77,23.82,110,0
AMER,108,1492,29.47,1600,29.40,29.68,108,0
BUFD,108,300,20.46,5000,20.43,20.55,108,0
BAUG,106,3000,30.95,3700,30.84,31.01,106,0
OSCV,105,701,31.46,700,31.42,31.90,105,0
PEX,105,500,29.81,500,29.70,29.80,105,0
AESR,102,400,12.34,959,12.31,12.32,102,0
BLKC,101,300,16.06,300,16.00,16.06,101,0
IBHE,101,200,23.72,100,23.65,23.72,101,0
DFIC,100,1000,23.19,1300,23.13,23.30,100,0
DFIS,100,1300,23.00,1000,22.92,23.12,100,0
DFND,100,400,35.78,1600,35.41,35.56,100,0
FFTI,100,700,21.76,800,21.72,21.73,100,0
IBHH,100,900,24.40,1000,24.37,24.40,100,0
ISVL,100,1000,32.15,1000,32.07,32.18,100,0
MSMR,100,7000,22.58,7100,22.53,22.46,100,0
MSVX,100,1600,26.03,1600,25.96,26.01,100,0
QDEC,100,900,20.43,3200,20.33,20.62,100,0
QSPT,100,400,18.38,200,18.27,18.42,100,0
TTAC,100,1600,48.99,1600,48.91,48.85,100,0
XJR,100,500,35.10,1100,35.05,35.34,100,0
YDEC,100,400,19.46,43,19.42,19.48,100,0
YMAR,100,200,18.88,200,18.78,18.99,100,0
YJUN,99,400,18.77,200,18.69,18.75,99,0
IBMQ,95,200,24.86,3300,24.83,24.86,95,0
VWID,95,1000,26.23,1000,26.20,26.19,95,0
EFAD,90,500,37.66,500,37.56,37.86,90,0
BJUN,88,400,32.48,200,32.34,32.56,88,0
DOCT,86,500,31.57,100,31.48,31.60,86,0
BMAR,85,700,33.14,300,33.03,33.19,85,0
BOCT,83,3200,32.29,3000,32.18,32.37,83,0
DFNV,83,2600,23.94,2600,23.86,24.10,83,0
GSUS,81,2100,57.02,2000,56.95,57.28,81,0
HYXU,81,1800,45.34,600,45.16,45.26,81,0
PBTP,81,1100,26.26,9700,26.25,26.27,81,0
PJUL,75,1300,29.72,300,29.64,29.60,75,0
IEME,74,500,28.14,506,28.08,28.38,74,0
MOTG,72,1000,34.17,1000,34.11,34.20,72,0
TMAT,71,400,14.78,400,14.73,15.03,71,0
FSEP,70,3500,33.53,3000,33.43,33.61,70,0
FPRO,69,1000,25.74,1000,25.72,25.70,69,0
PLRG,68,89,25.51,1500,25.49,25.60,68,0
PBSM,67,300,34.02,300,33.93,34.00,67,0
AGT,66,600,27.26,700,27.22,27.28,66,0
XSHD,61,700,20.81,1,20.79,20.82,60,1
KWT,60,100,40.15,40,40.03,40.03,60,0
FSMO,55,1000,21.12,12,21.10,21.20,55,0
FDHT,50,1100,20.29,1000,20.20,20.31,50,0
PBND,50,3100,23.31,600,23.21,23.23,50,0
SATO,50,1000,13.18,1000,13.13,13.44,50,0
PNOV,49,400,29.36,200,29.31,29.30,49,0
XDEC,49,400,29.18,200,29.08,29.20,49,0
VFMF,48,1700,98.20,2000,98.03,98.44,48,0
QMOM,46,500,46.81,100,46.73,47.00,46,0
PFEB,44,3400,28.23,3000,28.12,28.33,44,0
ESGG,41,300,130.79,105,130.50,130.71,41,0
XBJL,40,500,25.86,500,25.71,25.72,40,0
EFNL,39,1000,39.36,300,39.17,39.30,39,0
FLQS,38,100,34.11,100,34.05,34.36,38,0
TTAI,38,1600,30.19,1600,30.09,30.28,38,0
ENOR,35,300,28.42,500,28.29,28.43,35,0
PBUS,35,1000,41.82,1000,41.61,41.73,35,0
XJH,34,1500,34.10,1100,34.02,34.13,34,0
IVSG,33,1300,11.21,10200,11.20,11.21,33,0
FAIL,32,619,22.33,15,20.89,22.33,32,0
HELX,32,100,32.83,100,32.02,32.65,32,0
FMIL,31,100,29.15,100,29.06,29.32,31,0
FMAG,27,1000,20.34,1000,20.31,20.36,27,0
PBDM,27,100,25.39,500,25.09,25.14,27,0
QCON,27,500,43.53,500,43.43,43.62,27,0
RESE,26,600,30.03,600,29.84,30.09,26,0
VFMO,26,1100,117.12,1100,116.88,117.00,26,0
IEDI,25,700,41.72,600,41.66,42.11,25,0
JBBB,25,600,49.77,1700,49.64,49.77,25,0
LUXE,23,1600,23.67,1590,23.53,23.58,23,0
OEUR,21,680,24.42,600,24.39,24.48,21,0
EGIS,20,1200,32.58,1200,32.48,32.56,20,0
DDWM,17,1000,29.94,1000,29.88,29.92,17,0
MAGA,17,300,39.33,300,39.25,39.66,17,0
BOSS,16,100,26.64,900,26.57,26.72,16,0
RDFI,16,2600,24.62,2600,24.50,24.51,16,0
FDEM,15,800,23.37,101,23.15,23.57,15,0
NETZ,15,400,48.50,400,48.45,48.39,15,0
IPPP,12,3000,10.75,100,10.69,10.83,12,0
ROCI,12,3800,23.54,3000,23.49,23.73,12,0
BJAN,11,32,34.11,3000,34.04,34.23,11,0
CVAR,10,1600,25.55,1600,25.46,25.85,10,0
ICOW,10,500,29.25,500,29.14,29.34,10,0
TYA,10,4400,19.00,592,18.95,18.95,10,0
AFIF,8,4600,9.22,4708,9.20,9.20,8,0
HAUS,8,800,21.10,25,21.08,21.10,8,0
FOMO,6,1600,19.65,1600,19.60,19.60,6,0
IVDG,6,11200,10.54,11200,10.52,10.62,6,0
WUGI,6,18,43.00,500,42.99,43.08,6,0
JMUB,5,723,50.12,800,50.05,50.09,5,0
PUNK,5,300,21.15,300,21.06,21.37,5,0
QLC,4,600,46.29,400,46.25,46.30,4,0
EMDV,3,100,49.23,100,48.83,49.21,3,0
FFTG,3,400,27.72,300,27.64,27.77,3,0
IVRA,3,1100,15.51,1100,15.45,15.37,3,0
MOHR,3,2398,21.96,2400,21.91,22.10,3,0
QVAL,3,300,35.14,300,35.08,35.10,3,0
STOT,3,1700,47.43,1800,47.26,47.33,3,0
XTAP,3,300,27.20,300,27.05,27.10,3,0
ACSI,2,4500,46.34,4500,46.29,46.57,2,0
ADFI,2,400,8.80,400,8.77,8.87,2,0
FLTN,2,1600,24.80,1600,24.60,24.72,2,0
IVLC,2,1200,13.05,1200,13.03,13.09,2,0
KNGS,2,100,18.70,100,18.45,18.66,2,0
PSMB,2,400,15.59,400,15.50,15.49,2,0
SFIG,2,600,48.21,600,48.04,48.17,2,0
VAMO,2,1,27.20,8,26.15,26.42,2,0
WDNA,2,1000,18.34,1000,18.27,18.40,2,0
BDEC,1,400,32.31,3500,32.22,32.37,1,0
BMAY,1,3000,30.50,3700,30.41,30.50,1,0
BOB,1,500,23.90,2100,23.84,23.94,1,0
ESCR,1,100,19.33,100,19.15,19.28,1,0
EUDV,1,100,45.22,1,45.10,45.32,1,0
EWGS,1,200,66.61,300,66.43,66.91,1,0
FFHG,1,1500,33.40,1500,33.31,33.38,1,0
GEMD,1,200,43.93,300,43.78,43.88,1,0
IMFL,1,100,22.46,100,22.40,22.48,1,0
IMOM,1,300,27.47,300,27.39,27.43,1,0
JPIB,1,900,47.72,42,47.69,47.70,1,0
PSCQ,1,500,20.30,500,20.17,20.19,1,0
PSFO,1,500,20.42,500,20.29,20.34,1,0
PSMM,1,800,14.42,400,14.34,14.42,1,0
QTAP,1,400,27.06,200,26.95,27.09,1,0
ROMO,1,100,26.33,100,26.27,26.59,1,0
TILT,1,23,160.89,100,160.69,161.29,1,0
VMOT,1,700,24.86,700,24.78,24.76,1,0
WBAT,1,1000,35.45,1100,35.24,35.52,1,0
YPS,1,7000,22.60,7000,22.54,22.53,1,0
ALTS,0,500,38.80,500,38.51,0.00,0,0
APRZ,0,500,25.71,3000,25.62,0.00,0,0
APXH,0,3600,8.74,3600,8.70,0.00,0,0
ARCM,0,1500,99.60,1500,99.03,0.00,0,0
AUGZ,0,3000,30.91,3000,30.79,0.00,0,0
AVDG,0,1600,28.66,1600,28.59,0.00,0,0
BAPR,0,400,32.00,500,31.87,0.00,0,0
BGLD,0,100,19.17,100,19.06,0.00,0,0
BJUL,0,300,31.23,300,31.14,0.00,0,0
BNOV,0,700,30.36,300,30.27,0.00,0,0
BUFB,0,400,23.70,1200,23.62,0.00,0,0
BUYZ,0,700,26.49,700,26.39,0.00,0,0
CFCV,0,1600,32.19,1600,32.06,0.00,0,0
CLSE,0,1100,15.57,300,15.52,0.00,0,0
DAUG,0,900,33.63,700,33.47,0.00,0,0
DBJA,0,100,25.93,100,25.82,0.00,0,0
DBOC,0,200,28.43,200,28.33,0.00,0,0
DECZ,0,3000,27.77,1000,27.68,0.00,0,0
DFRA,0,2600,26.74,2600,26.67,0.00,0,0
DJUL,0,3000,32.20,3200,32.08,0.00,0,0
DJUN,0,400,33.35,300,33.23,0.00,0,0
DMAY,0,3000,33.38,3200,33.23,0.00,0,0
DSEP,0,3000,31.59,500,31.49,0.00,0,0
DSJA,0,100,26.19,100,26.06,0.00,0,0
DSOC,0,300,29.95,300,29.84,0.00,0,0
EAOA,0,300,30.01,400,29.98,0.00,0,0
EAOK,0,400,25.06,300,25.04,0.00,0,0
EAOM,0,2600,26.04,400,26.00,0.00,0,0
EMSH,0,200,65.40,300,65.00,0.00,0,0
EOPS,0,1600,18.17,1600,18.08,0.00,0,0
ESEB,0,1700,17.81,1600,17.64,0.00,0,0
ESHY,0,1700,19.33,100,19.14,0.00,0,0
EUCG,0,1600,21.58,1600,21.48,0.00,0,0
FAUG,0,900,36.14,600,35.98,0.00,0,0
FEBZ,0,3000,27.36,500,27.24,0.00,0,0
FEDX,0,800,26.18,3,26.15,0.00,0,0
FFSG,0,300,33.43,300,33.30,0.00,0,0
FIBR,0,700,88.89,600,88.64,0.00,0,0
FJUN,0,400,36.06,200,35.91,0.00,0,0
FLIA,0,800,23.59,3000,23.53,0.00,0,0
FUNL,0,500,33.55,500,33.49,0.00,0,0
FUT,0,600,41.69,100,41.54,0.00,0,0
GCLN,0,1000,37.29,1100,37.09,0.00,0,0
GDE,0,100,24.24,100,24.02,0.00,0,0
GHTA,0,6400,23.13,1600,23.03,0.00,0,0
GLDB,0,1600,21.99,1600,21.80,0.00,0,0
GLOV,0,1000,40.79,1000,40.70,0.00,0,0
GPAL,0,600,34.94,600,34.88,0.00,0,0
GSEE,0,1000,43.19,1100,42.87,0.00,0,0
GSID,0,1000,48.83,1100,48.71,0.00,0,0
GSST,0,900,50.15,1,50.14,0.00,0,0
HEET,0,300,23.48,300,23.44,0.00,0,0
HSRT,0,300,39.06,1700,38.90,0.00,0,0
HYBL,0,1000,29.40,1000,29.38,0.00,0,0
IBHI,0,1000,24.20,100,24.15,0.00,0,0
IGLD,0,100,20.79,100,20.65,0.00,0,0
IMLP,0,500,14.82,400,14.77,0.00,0,0
IPDP,0,3000,15.63,3000,15.54,0.00,0,0
IQM,0,500,39.06,400,38.92,0.00,0,0
JANZ,0,3000,26.63,3000,26.53,0.00,0,0
JULZ,0,3000,32.10,500,31.99,0.00,0,0
JUNZ,0,3500,25.04,500,24.93,0.00,0,0
KJAN,0,400,29.71,200,29.53,0.00,0,0
KJUL,0,400,24.80,200,24.68,0.00,0,0
KOCT,0,400,25.21,200,25.09,0.00,0,0
LIV,0,1600,19.21,1600,19.16,0.00,0,0
LYFE,0,1300,30.59,1300,30.48,0.00,0,0
MAAX,0,500,21.76,650,21.70,0.00,0,0
MAMB,0,600,23.16,600,23.14,0.00,0,0
MARZ,0,500,25.53,500,25.42,0.00,0,0
MAYZ,0,3500,24.40,3000,24.29,0.00,0,0
MBBB,0,600,21.76,3300,21.71,0.00,0,0
MBCC,0,600,23.92,600,23.89,0.00,0,0
MBND,0,400,27.07,400,27.02,0.00,0,0
MBNE,0,100,29.71,2000,29.54,0.00,0,0
MDEV,0,1000,20.02,1000,19.95,0.00,0,0
MFUL,0,1600,22.11,1600,22.08,0.00,0,0
MIG,0,600,21.87,3300,21.82,0.00,0,0
MOTE,0,100,22.74,500,22.70,0.00,0,0
MPRO,0,600,26.64,500,26.62,0.00,0,0
MRGR,0,500,40.86,1990,40.73,0.00,0,0
MRSK,0,2300,27.70,2300,27.59,0.00,0,0
MSTQ,0,1600,24.54,1600,24.45,0.00,0,0
NJUL,0,400,44.54,200,44.36,0.00,0,0
NOCT,0,400,37.01,200,36.85,0.00,0,0
NOVZ,0,3000,30.57,3500,30.48,0.00,0,0
NUDV,0,600,25.14,600,25.12,0.00,0,0
NULC,0,600,35.71,600,35.67,0.00,0,0
OBND,0,2600,27.89,600,27.78,0.00,0,0
OCTZ,0,3500,29.89,3500,29.77,0.00,0,0
PAUG,0,3000,29.14,700,29.03,0.00,0,0
PDEC,0,3400,29.93,3000,29.82,0.00,0,0
PLTL,0,300,23.51,300,23.45,0.00,0,0
PMAY,0,3900,29.03,700,28.91,0.00,0,0
POCT,0,3400,29.21,500,29.11,0.00,0,0
PSCW,0,3000,21.44,3500,21.33,0.00,0,0
PSCX,0,3000,21.38,3000,21.29,0.00,0,0
PSFM,0,3000,21.97,500,21.86,0.00,0,0
PSMC,0,800,12.76,600,12.72,0.00,0,0
PSMG,0,800,17.39,23,17.35,0.00,0,0
PSMJ,0,500,20.54,500,20.42,0.00,0,0
PSMR,0,500,21.57,3500,21.47,0.00,0,0
PXUS,0,200,21.78,500,21.70,0.00,0,0
QPFF,0,200,37.53,3,37.50,0.00,0,0
QTJA,0,1000,20.25,1000,20.17,0.00,0,0
QTJL,0,400,22.88,200,22.76,0.00,0,0
QTOC,0,300,21.80,200,21.70,0.00,0,0
REC,0,100,22.25,100,22.08,0.00,0,0
RODE,0,2000,26.74,500,26.64,0.00,0,0
RODI,0,100,144.43,200,87.19,0.00,0,0
RPHS,0,3600,9.37,3600,9.29,0.00,0,0
RSEE,0,1600,24.70,1600,24.63,0.00,0,0
RSX,0,0,0.00,0,0.00,0.00,0,0
RSXJ,0,0,0.00,0,0.00,0.00,0,0
RTAI,0,3400,22.24,2600,22.14,0.00,0,0
RULE,0,2400,21.71,2400,21.66,0.00,0,0
SEPZ,0,3000,29.74,3000,29.61,0.00,0,0
SMI,0,600,45.81,600,45.78,0.00,0,0
SPMV,0,200,38.61,400,38.51,0.00,0,0
STLG,0,800,32.96,800,32.90,0.00,0,0
STLV,0,900,28.28,900,28.22,0.00,0,0
TBJL,0,300,22.15,300,22.07,0.00,0,0
TCTL,0,3200,30.16,300,30.07,0.00,0,0
TFJL,0,400,22.01,4900,21.93,0.00,0,0
THY,0,1600,23.71,1600,23.68,0.00,0,0
TRDF,0,1600,22.65,1600,22.59,0.00,0,0
TSJA,0,300,26.02,300,25.87,0.00,0,0
TSOC,0,300,29.24,300,29.10,0.00,0,0
USEQ,0,300,35.49,300,35.37,0.00,0,0
VFLQ,0,700,96.86,800,96.73,0.00,0,0
VIRS,0,500,28.91,500,28.86,0.00,0,0
WFIG,0,1800,46.86,600,46.75,0.00,0,0
WIL,0,100,91.07,100,89.01,0.00,0,0
WLDR,0,300,24.90,1,24.66,0.00,0,0
WTAI,0,1000,17.11,1000,17.05,0.00,0,0
XBJA,0,3000,22.77,3000,22.68,0.00,0,0
XBOC,0,3000,23.96,3100,23.83,0.00,0,0
XDAP,0,3000,27.30,3100,27.17,0.00,0,0
XDAT,0,1600,19.63,1600,19.55,0.00,0,0
XDJA,0,3000,21.61,600,21.52,0.00,0,0
XDJL,0,500,25.36,500,25.24,0.00,0,0
XDOC,0,3000,23.66,500,23.59,0.00,0,0
XDQQ,0,3000,24.35,3100,24.24,0.00,0,0
XDSQ,0,500,25.24,3100,25.16,0.00,0,0
XJUN,0,500,29.73,500,29.59,0.00,0,0
XSHQ,0,300,33.53,300,33.43,0.00,0,0
XTJA,0,200,21.72,200,21.62,0.00,0,0
XTOC,0,200,23.81,200,23.68,0.00,0,0
YSEP,0,400,18.26,200,18.18,0.00,0,0